XXXXXXXXXXXXXXX
XXX   S  XXXXXX
XXX X XX   G  X
X   XXXXXXXX XX
XXX XXXXXXXX XX
XXX XX       XX
X   XX XXXXXXXX
XXX           X
X   XX XXXXXX X
XXXXXXXXXXXXXXX