XXXXXXXXXXXXXXXXXXXXXXXXXXXXXXX
XXX   S  XXXXXXXX    XX     XXX
XXX X XX        X X XXX X X XXX
X   XXXXXXXX XX X X XXX X X XXX
XXX XXXXXXXX XX X X XXX X XXXXX
XXX XX       XX X X  XX X XXXXX
X   XX XXXXXXXX X XXXXX X  GXXX
XXX           X         XXXXXXX
X   XX XXXXXX XXXXXX XXXXXXXXXX
XXXXXXXXXXXXXXXXXXXXXXXXXXXXXXX