XXXXXXXXXX
X S     XX
X G    X X
X     X  X
X    X   X
X   X    X
X  X     X
X X      X
XX       X
XXXXXXXXXX