XXXXXXXXXX
X S     XX
X      X X
X     X  X
X X  X G X
X XXX    X
X    X   X
X X      X
XX       X
XXXXXXXXXX